########
#i     #
# ##### #
# #   # #
# # # # #
# # # # #
#     O#
########
