#i#  #
#  #  #
#  #  #
#  #  #
#  #O#
